 0  1  2  3  4  5 78 78 78  0  1  2  3  3  4  5
10 11 12 13 14  1  2  1  2  3 11 12 13 13 14  5
10 21 22 23 22 12 13 12 13 12 22 23 22  8 24  5
10 21 22 23 22 26 22 23 22 26 22 23 22 26 24  5
10 21 22 23 22 32 33 32 33 32 22 23 22 23 24  5
10 21 22 23 24  1  2  1  2  3 21 22 23 23 24  5
10 21 22 23 22 12 13 12 13 12 22 23 22 23 24  5
10 21 22 23 22 23 22 23 22 23 22 23 22 23 24  5
10 21 22 23 22 23 22 23 22 23 22 23 22 23 24  5
10 21 22 23 22 23 22 23 22 23 22 23 22 23 24  5
10 31 32 33 32 33 32 33 32 33 32 33 32 33 34  5
40 41 42 43 44 41 42 43 44 41 42 43 44 41 42 45